#name
El hub
#description
Lugar de inicio.
#width
12
#height
7
#data
3,3,3,3,3,0,0,0,3,3,3,3
3,0,3,0,0,0,0,0,3,0,0,0
3,0,3,0,2,1,2,0,0,0,0,0
0,0,0,0,0,0,0,0,0,0,0,0
3,0,3,0,0,0,0,0,3,0,0,3
3,0,3,0,0,0,0,0,3,0,0,3
3,3,3,3,3,0,3,0,3,3,3,3